21 21 40
00 25 22 22 22 22 22 22 22 22 34 22 22 22 22 22 22 22 22 24 00
00 26 03 03 03 03 03 03 03 03 26 03 03 03 03 03 03 03 03 26 00
00 26 04 11 13 03 11 22 13 03 12 03 11 22 13 03 11 13 04 26 00
00 26 03 03 03 03 03 03 03 03 03 03 03 03 03 03 03 03 03 26 00
00 26 03 11 13 03 14 03 11 22 34 22 13 03 14 03 11 13 03 26 00
00 26 03 03 03 03 26 03 03 03 26 03 03 03 26 03 03 03 03 26 00
00 21 22 22 24 03 31 22 13 03 12 03 11 22 33 03 25 22 22 23 00
00 00 00 00 26 03 26 03 03 03 05 03 03 03 26 03 26 00 00 00 00
00 22 22 22 23 03 12 03 25 13 10 11 24 03 12 03 21 22 22 22 00
15 02 03 03 03 03 03 03 26 02 02 02 26 03 03 03 03 03 03 02 15
00 22 22 22 24 03 14 03 21 22 22 22 23 03 14 03 25 22 22 22 00
00 00 00 00 26 03 26 03 03 03 03 03 03 03 26 03 26 00 00 00 00
00 25 22 22 23 03 12 03 11 22 34 22 13 03 12 03 21 22 22 24 00
00 26 03 03 03 03 03 03 03 03 26 03 03 03 03 03 03 03 03 26 00
00 26 03 11 24 03 11 22 13 03 12 03 11 22 13 03 25 13 03 26 00
00 26 04 03 26 03 03 03 03 03 03 03 03 03 03 03 26 03 04 26 00
00 31 13 03 12 03 14 03 11 22 34 22 13 03 14 03 12 03 11 33 00
00 26 03 03 03 03 26 03 03 03 26 03 03 03 26 03 03 03 03 26 00
00 26 03 11 22 22 32 22 13 03 12 03 11 22 32 22 22 13 03 26 00
00 26 03 03 03 03 03 03 03 03 03 03 03 03 03 03 03 03 03 26 00
00 21 22 22 22 22 22 22 22 22 22 22 22 22 22 22 22 22 22 23 00